text	label
Want more? Be sure to check out HuffPost Style on Twitter, Facebook, Tumblr, Pinterest and Instagram at @HuffPostStyle. The	STYLE & BEAUTY
Sen. John McCain, R-Ariz., says he understands why Hillary Clinton decided to write her campaign memoir, ‚ÄúWhat Happened,‚Äù which	POLITICS
I stand at the end of the production line, clutching a thin slice of toasted bread in my hand and eagerly awaiting the new oil.	TRAVEL
The unfortunate thing is these people are all using the elliptical to get a cardio workout. The truth is they'll never see	WELLNESS
"No one dethrones Beyonce. After the ""Frozen"" soundtrack bumped her new self-titled album to the No. 2 spot on the Billboard"	ENTERTAINMENT
Unlike the Oscars, Met Gala or other major red carpets, the Cannes Film Festival is a marathon, not a sprint. This year's	STYLE & BEAUTY
Have you ever had the feeling there's a better version of you hiding somewhere deep inside, like a bird in a cage, just waiting to be set free?  Maybe your personal metaphor is the same as mine.  I've always thought of myself as a diamond in the rough.	WELLNESS
The truth is, happiness is hard work, no matter what your IQ, age, weight, or marital status. Happiness doesn't come to you, you have to create it.	WELLNESS
"""We observed a seasonal variation in waist circumference but BMI did not change throughout the year,"" Marques-Vidal said"	WELLNESS
All in all, the St Regis is a lovely horizontal ivory tower isolated on the tip of Princeville. I leave Kauai¬†always¬†wanting more.	TRAVEL
We can't wait until June 2.	ENTERTAINMENT
"""The Big Short"" opens in December."	ENTERTAINMENT
I recently hopped on a two and a half hour flight from New York City to Palm Beach for a three-day trip to celebrate my fiance's 30th birthday. The thing is, we whipped together this vacation in a matter of weeks.	TRAVEL
Charlottesville, Houston, the Border Wall, Human Rights, Women‚Äôs Clinics, Poverty, Wealth, Education, Illiteracy, Homelessness	POLITICS
The FBI arrested 20-year-old Jonathan Xie, saying he donated to Hamas, lied on an application to enlist in the Army, and threatened supporters of Israel.	POLITICS
1. Naturistics Lip Sparklers Yes, the classic nail polish remover brand dabbled with cosmetics. And they made pretty darn	STYLE & BEAUTY
Usually, the two of us don't agree on anything about politics.	POLITICS
"But GOP candidate Rick Saccone also claimed to be unions' ""biggest salesman."""	POLITICS
"Jon Kabat-Zinn, founder of Mindfulness-Based Stress Reduction (MBSR), talks about the present moment and the ""thousand-year view"" with Omega."	WELLNESS
This year, instead of putting myself through the entirely self-generated cycle of hype versus reality, I decided to just leave the country for my birthday. My best friend and I booked a trip to Greece, land of luxurious beaches, gorgeous sunsets and more than a little history.	TRAVEL
Every year around this time, TripAdvisor releases its list of the world's best beaches. Culled from a list of 276 beaches	TRAVEL
Most find about half of the public in favor.	POLITICS
And you thought the finale was upsetting.	ENTERTAINMENT
For well over half a century the U.S. has depended on its Intelligence Community as the first line of defense in meeting	POLITICS
‚ÄúI hope by the time I‚Äôm your age, we would have educated our children ... on today‚Äôs issues and we wouldn‚Äôt have kept them in a bubble.‚Äù	POLITICS
The changes have stoked fears they are aimed at holding up mail-in election ballots.	POLITICS
In a Feb. 13 statement, Katherine Rich, chief executive of the New Zealand Food & Grocery Council, an industry association	WELLNESS
His ad is clearly designed to scare and confuse voters.	POLITICS
This week, Mika Brzezinski and I hosted our second Third Metric conference. Last year, we had 300 people crammed into my living room. This year, we had over 2,000 people at the New York City Center -- all embracing the notion that success needs to be redefined beyond money and power. Over the two days of the event, we were collectively inspired, moved, encouraged and galvanized as we heard from neuroscientists, authors, singers, entrepreneurs, yoga instructors, CEOs, comedians and medical doctors. And we took away practical tools and tips to allow us to incorporate more well-being, wisdom, wonder and giving into our daily lives. We wanted the conference to serve as a bridge -- from knowing to doing, from idea to action. Thanks to everyone, onstage and off, who crossed that bridge with us -- and you can make the journey too by watching the video of the event here.	POLITICS
He made a lot of pint-sized friends.	POLITICS
Listen to the critics.	POLITICS
"""Hello there, your honor. I want to say I'm sorry for the things I've done."""	ENTERTAINMENT
Shippers rejoice.	ENTERTAINMENT
And all your other unanswered Batman questions, too.	ENTERTAINMENT
Dad jokes for days.	ENTERTAINMENT
Orange lips and nails were the brightest accessory on the Spring 2014 runways at Rag & Bone, Creatures of the Wind and Suno	STYLE & BEAUTY
In the first half of 2012, U.S. airlines raked in $1.7 billion in baggage fees, the largest amount ever collected by the industry in a six-month period. But, with a little know-how and some planning ahead, you can beat 'em.	TRAVEL
Made up of Guy-Manuel de Homem-Christo and Thomas Bangalter, the French group has two decades of experience. Daft Punk's	ENTERTAINMENT
Kids nowadays are under a tremendous amount of stress with a push from our educational institutions and from parents to get the best grades, do the most extracurricular activities and conform to fit into the highest social circles.	WELLNESS
United Airlines did not immediately respond with comment. UPDATE: According to AP, police escorted a man claiming to have	TRAVEL
And the Moonman goes to ...	ENTERTAINMENT
Free People has become our go-to store for everything from boho dresses to lacy bras to stackable bangles, so we were pretty	STYLE & BEAUTY
Clinton helped write the first 9/11 health bills in the Senate when she represented New York.	POLITICS
Past behavior is often an indicator of current or future behavior, even in relationships.  If he's done it before it only makes it easier to do it again.	WELLNESS
Last year, a study of 35,533 men was published in the Journal of the American Medical Association showing that taking vitamin	WELLNESS
It's safe to say Kate Upton has had some pretty wide-ranging photo shoots in her career so far. And before she got glam for	STYLE & BEAUTY
Rep. Chris Collins added that safety would improve if more people carried guns.	POLITICS
"""They're going to try to get blood out of a stone, and that's not good for anyone but the debt collectors."""	POLITICS
This is not a dream (sequence).	ENTERTAINMENT
Hill yes!	ENTERTAINMENT
Why are babies in first class, or on airplanes in general, such a big deal? Sound off in the comments below. Early last year	TRAVEL
Although selling such lenses without a prescription is actually illegal, cosmetic lenses can still be found in stores and	WELLNESS
Walker has been involved in two of these probes.	POLITICS
TripAdvisor has released their list for the best hotel spas around America in 2012 as part of their annual wellness travel	TRAVEL
Think she's headed for the Best-Dressed List? An exact doppelg√§nger? Hardly. But Eve's gorgeous red carpet ensemble has us	STYLE & BEAUTY
Tune in on July 20 to watch our panel discussion with union organizers from the Amazon, REI, Starbucks and Apple battles.	POLITICS
From Sammy Davis Vintage: Caitlin of Wore Out, a Burlington, Vermont-based style blog, purchased this paisley print turban	STYLE & BEAUTY
By PureWow There are only so many hours you can spend on a stationary bike before you're ready to swear off spin entirely	WELLNESS
We have way too much time on our hands.	POLITICS
Critically important decisions about who gets to live and who dies are being made ‚Äî often along racial lines ‚Äî by an almost uniformly white group of prosecutors.	POLITICS
Not even the politically vulnerable ones are afraid to defy Trump.	POLITICS
Along with an Afro pick, chocolate milk and cereal.	POLITICS
Celebrating the best Hollywood has to offer.	ENTERTAINMENT
Thank you, ‚ÄúThanksgiving.‚Äù Last September, writer-actress Lena Waithe made history and became the first black woman to win	ENTERTAINMENT
"""You‚Äôre only as good as the people that you work with,‚Äù Lopez said during her acceptance speech."	ENTERTAINMENT
Each day of the journey brought unpredictable thrills and excitement. And it wasn't just the landscapes that floored me.	TRAVEL
The Senate Foreign Relations Committee heeded warnings from former officials and modified the legislation.	POLITICS
I have a surprise to reveal: Most celebrities don't have perfect figures; rather they understand a few key secrets behind the art of dressing.	STYLE & BEAUTY
"""She‚Äôs going to do nothing for African-Americans, she‚Äôs going to do nothing for the Hispanics."""	POLITICS
"By now, we know there are both ""good"" fats and ""bad"" fats. But what's the difference? Certain foods blow that count right"	WELLNESS
"'They say, 'Donald, you brought something up to the fore that is so brilliant and so fantastic.'"""	POLITICS
You are driving in the city, in line at a red light.  Three cars ahead, you spot the weathered man or woman working his way up the line of windows, hand out, maybe a sign explaining his plight. Is there a flash of wanting the light to change before he makes it up to you?	WELLNESS
This would be the first of three battles that would be fought here over the course of the war. This area was particularly important to the British who needed to protect, from possible attack, their supply lines from the channel ports.	POLITICS
The word ‚Äúhistoric,‚Äù already being used to describe the just-accepted Paris climate agreement, is more than warranted. The	POLITICS
Ever wonder why Miranda Kerr's feet are so perfect and polished? Well, it turns out her hubby Orlando Bloom has a bit of	STYLE & BEAUTY
This week's unanimous Supreme Court decision affirming a robust Fourth Amendment protection for cellphone data is an enormously important victory for privacy rights in the digital age.	POLITICS
I believe that 'connecting to our connectedness' is one of the keys to sustainable change.	WELLNESS
There‚Äôs still hope and momentum behind paid parental and sick leave.	POLITICS
Kshama Sawant was re-elected to Seattle's city council this week.	POLITICS
Whether you're preparing for a short trip or a long holiday break, knowing the rules and strategizing accordingly can help you avoid major hassles, not to mention hefty change fees. Here are eight practical tips for handling tricky situations and winging it when things don't go your way.	TRAVEL
As a result, we will be increasing your post-exercise oxygen consumption (EPOC), which is really a fancy way to say that you are going to burn more calories, even after the cardio session ends.	WELLNESS
"""Your husband and son are black. Are you concerned?‚Äù one commenter wrote."	ENTERTAINMENT
Weight-loss pitches come fast and furious this time of year: diet meal delivery plans, gym memberships, even high-tech scales	WELLNESS
üëèüè® üí•	TRAVEL
A few months ago, I had the pleasure of traveling around Ireland and London with my mother and sister during a 12-day vacation we'd been planning since I was in high school.	TRAVEL
The one-page outline is really just a plan for the president to lower his own taxes, Chuck Schumer said.	POLITICS
Click through the slideshow below to see these fishtail braid hairstyles, and tell us in the comments section which look	STYLE & BEAUTY
"""Honesty suddenly seems cool,‚Äù the late-night host said."	ENTERTAINMENT
"""You built the middle class, that's not an exaggeration."""	POLITICS
For more poetry for the soul, click here. When you let me in your life, all the way in, we took this walk that turned into	WELLNESS
Remember, life is not about reality, it is about the stories we tell ourselves about what is going on.	WELLNESS
To be mindful of speech means to notice your intention before you speak and to listen with full attention. There are certainly times when I've said things I regret.	WELLNESS
A look at Le Pen's rise.	POLITICS
Research is beginning to show that, while technology may not replace in-person therapy, advances are making life better for survivors.	WELLNESS
With every life-changing decision, I've received great advice from trusted sources. But I've also heard some of the worst advice about changing my life for the better. And you'll probably hear it too.	TRAVEL
‚ÄúTRAFFIC STOP‚Äù: MARCH 12 When Breaion King, an African-American schoolteacher from Austin,¬†Texas, was pulled over for a routine	ENTERTAINMENT
The Global Scavenger Hunt travel adventure competition has arrived in the Middle East, and the competition is heating up.	TRAVEL
"The ""Saturday Night Live"" comedian equated the church's sex abuse scandal with the singer's in a ""Weekend Update"" bit."	ENTERTAINMENT
"""Their pro-gun policies have resulted in dead children, dead mothers and dead fathers,"" says Democratic congressional candidate Pat Davis."	POLITICS
Seeing the Japanese care for each other and refuse to fall into despair always leaves me with hope for their culture and country.	TRAVEL
"""I keep waiting for us to get tired of going after the new fad diet. But our appetite for these things is insatiable in the"	WELLNESS
Police are reportedly taking items out of his home over a civil case.	ENTERTAINMENT
The island of Jamaica is a popular tourist destination because of its tropical climate, craggy coastline with white sandy beaches, lush tree and ground vegetation, verdant golf courses, zesty foods paired with reggae and rum and long tradition of warmth and hospitality.	TRAVEL
Spooky stuff began to happen in 1930 when a new family moved in. They claimed to see the ghost of their son, a young war hero who had died in WWI.	TRAVEL
"Press secretary Sean Spicer said they are only in the ""first chapter"" of this investigation."	POLITICS
On a recent trip to Southern California, Caroline Gault, guest editor to Vitamin Daily, was so blown away by the beachy-chic lifestyle of Santa Monica that she decided to drop everything and move there.	TRAVEL
It is important for us to realize what too much multitasking can do to our brains. Some interesting brain research from Your Brain at Work by David Rock tells us that to focus more effectively, we must retrain our mind for uninterrupted concentration.	WELLNESS
"""He's the most talented politician that New England has produced since John Kennedy."""	POLITICS
God bless all the tourists who run around the globe checking out all those famous spots that simply can't be missed. While	TRAVEL
"The pop superstar said she was ""completely inspired"" by Roem's victory."	ENTERTAINMENT
Did someone tell Patty Hewes?	ENTERTAINMENT
GOP lawmakers have widely condemned his remarks.	POLITICS
Yeeeaaah, no.	ENTERTAINMENT
Women: To achieve maximal health, you need to get stronger. Get under some weights and lift. anything you read in any women's fitness magazine is suspect. Actually, it's not just suspect -- you can be guaranteed that they're feeding you inaccurate trash.	WELLNESS
It is self-evident that equal opportunity is a necessary quality of a fair society, but to achieve this an inefficient redistribution of wealth is required.	POLITICS
Werk it, POTUS.	STYLE & BEAUTY
Trump is expected to name Exxon Mobil's Rex Tillerson on Tuesday morning.	POLITICS
His campaign suggests Clinton is open to cutting benefits.	POLITICS
So how did we miss the episode about Brittoni, a 22-year-old woman who eats makeup? We're talking palettes and palettes of	STYLE & BEAUTY
Friday, January 20th 2017. The Inauguration of the 45th President was an emotional day. Many in this country experienced	POLITICS
Richard Maher, European University Institute President Donald Trump meets in Brussels today with leaders from the European	POLITICS
Serious spoiler alert.	ENTERTAINMENT
You may have already heard our big news in psychiatry: The first major revision of the  Diagnostic and Statistical Manual (DSM) since the mid-1990s has just been approved by American Psychiatric Association's Board of Trustees. And the new DSM-5 will be published in May.	WELLNESS
To avoid our own personal January 2 shutdowns, let's learn from Congress' transgressions. Let's be moderate, aim for pre-emptive physical and psychological wellness, and lead by example in both our voting and holiday season behaviors.	WELLNESS
White's cause of death has yet to be determined, but a rep for the LAPD said they don't comment on suicide investigations.	ENTERTAINMENT
As if I had only been more careful, then I would have been able to avoid this seven-year battle with cancer.	POLITICS
Immigrants want nothing but to start a new chapter in their lives, live in peace, and provide for their families.	POLITICS
Want more? Be sure to check out HuffPost Style on Twitter, Facebook, Tumblr and Pinterest. If anyone is the master of self	STYLE & BEAUTY
I chose to not risk oversleeping in Irkutsk by staying up and drinking beer in Harat's Pub near the hostel with a chatty boxing trainer who shared his chicken wings.	TRAVEL
As I toured some of the iconic desert modern homes, I suddenly got it.	TRAVEL
The state‚Äôs demographics favor Ted Cruz, but the economics and polls point to a Donald Trump win.	POLITICS
To make sure that each lady can find a bag that suits her personal tastes, her collection includes 12 styles available in	STYLE & BEAUTY
"One of the best phrases I hear at Brown is the question, ""How would you describe the typical Brown student?"" followed by the answer, ""There is none!"" Despite this gag-worthy clich√©, I must admit that it applies to the styles I see on Brown's campus."	STYLE & BEAUTY
19 Kris Jenner Moments That Make You Crack Up Every Time	ENTERTAINMENT
Do you have a style story idea or tip? Email us at stylesubmissions@huffingtonpost.com. (PR pitches sent to this address	STYLE & BEAUTY
Polls show a small lead for Democrat Jack Conway, but an independent candidate could be a factor.	POLITICS
The grudges now dividing the United States have taken the schism of He versus Her, in reference to President Donald Trump	POLITICS
Zinke has said repeatedly that he doesn't care about diversity, three unnamed Interior Department officials reportedly told CNN.	POLITICS
"What would an America under tyrannical Canadian rule look like? More polite? Cheaper health care? Would we all have to call macaroni and cheese ""Kraft dinner""? The best way to envision this nightmarish alternate-universe dystopia is to peek in on the quiet town of Hyder, Alaska."	TRAVEL
Which of our candidates (check them out in this photo gallery) deserves to be named USA TODAY's best college football town	TRAVEL
The trial against the two psychologists accused of developing the George W. Bush-era torture program is set for June.	POLITICS
It‚Äôs a response to the Paris terrorist attacks that the White House might actually approve.	POLITICS
Let me share the story of a group of five dear friends over the last five years. In 2010, my friends decided to pool their life savings to open a magnificent restaurant at the foot of the Acropolis, in the city where democracy was born, Athens...	POLITICS
So Mexico's not paying for it?	POLITICS
The president is due to give a speech about his national security plans later on Monday.	POLITICS
''Gremlins 2,'' ''Rolling Thunder,'' more great films worth a fresh look. Read more on EW.com	ENTERTAINMENT
Co-authored by Sarp Aksel MD Montefiore Medical Center, Lauren Broussard MSW, MPH DrPH(c) Columbia University, Meghan Eagen	POLITICS
Organizing this trip was not easy. I wasn't just thinking about how to survive the relationship (he was not my husband then), but how to budget, prepare, get the tickets, book hotels, and plan our itinerary and meetings for every city we would be visiting.	TRAVEL
An elementary schooler got to participate in the biggest sports event in America through Fuel Up to Play 60, a program that uses the star-power of NFL players to get kids excited about exercise.	WELLNESS
The former secretary of state needs to do much better on immigration and national security, according to the ACLU.	POLITICS
Colon cancer is a leading killer. Colon cancer is highly preventable. The stakes are high. But so is public confusion about screening guidelines.	WELLNESS
If you read me with any regularity, you'll know I'm obsessed with trying every new beauty product on the market that I can get my greedy little hands on	STYLE & BEAUTY
Arkansas, I am listening.	POLITICS
Caitlin FitzGerald and Mackenzie Davis star in Sophia Takal‚Äôs new film.	ENTERTAINMENT
Katy's schoolgirl outfit: So preppy plaid might not be the expected next move in the singer's style evolution, but she chose	STYLE & BEAUTY
Georgia is apparently the only state to have done this.	POLITICS
‚ÄúWe did it!‚Äù	POLITICS
That is, if the Supreme Court allows it.	POLITICS
Some time-tested, research-proven foods do earn their permanent stay at the table. They aren't miracles, but as part of a healthy diet and combined with burst training and weight resistance, they can yield impressive gains (or losses, if you will).	WELLNESS
International Jazz Day was celebrated, appropriately enough, in the city where jazz was born on the 4th day of the New Orleans Jazz & Heritage Festival 2015.	ENTERTAINMENT
Small, reasonable changes can add up to a lot of benefits in your future. Incremental adjustments can ensure the earthquake of a diabetes diagnosis never happens to you.	WELLNESS
Yoga has been shown in past studies to aid in back pain relief. Researchers found that yoga classes or stretching classes	WELLNESS
Discovering the Acropolis, seeing the Mona Lisa, walking on the Great Wall and watching the sunrise over the Taj Mahal are all undeniably spectacular travel experiences, yet nothing can compare to encountering the spellbinding magic of meeting Mother Nature's majestic creatures up close and in person.	TRAVEL
*Wipes tear*	POLITICS
This week, I share tips about European decor, featuring the advice of my friend and interior decorator Tom Landry, whose taste is completely in line with mine (he could be an adopted European, even though he is a New Orleanian).	STYLE & BEAUTY
The woman thought she was a, uh, werewolf.	ENTERTAINMENT
A new poll shows increased support for bigger government and increased federal spending.	POLITICS
Why are so many acceptance speeches so dull? As a linguist, I suspect it's the grammar -- the rules dictating their composition. That awardees are supposed to get to the stage and speechify in under a minute means that this grammar doesn't have many moving parts.	ENTERTAINMENT
2015 was a good year for the movie biz.	ENTERTAINMENT
"Most of us pay no heed to our mythology. It's the water we swim in, and we take it completely for granted. Or worse, we discount whatever smells of mythology. ""That's just a myth,"" the saying goes, meaning an untruth, something believed without a shred of evidence."	WELLNESS
It also blocks anti-discrimination protections for people seeking abortions.	POLITICS
In Congress, Democrats and Republicans alike are demanding more clarity about Moscow's role.	POLITICS
Not the one in Westeros, alas.	ENTERTAINMENT
If there's any doubt Congress is beholden to the powerful airline lobby, this should settle it: An influential group of representatives	TRAVEL
Phew!	STYLE & BEAUTY
By James M. Dorsey US president Donald J. Trump‚Äôs recognition of Jerusalem potentially sets the stage for a controversial	POLITICS
Cashiers, North Carolina, population 3,500, could be overrun with 30,000 to 100,000 starry-eyed tourists.	TRAVEL
When Matthew Penbross woke on a morning in August 2007--a day in which he'd be competing in motocross races near Port Macquarie	WELLNESS
This didn‚Äôt feel like an election. I‚Äôve voted in elections and weathered their results, for better or worse, for 28 years	POLITICS
The Giants and the Tigers definitely won't be able to blame any lackluster performances on where they shack up.	TRAVEL
Nightmares past and present.	POLITICS
Fighting your subconscious on anything is always a losing battle. You may have temporary gains, but over the long term, the odds are against you. There is, however, one facet to your relationship with your subconscious that will flip the struggle for supremacy on its head.	WELLNESS
The former Texas governor disavowed Trump's request for a list of employees working on climate change.	POLITICS
"We run a fitness business so let's be honest, our life is a playlist. We can't walk into a store or listen to the radio without thinking ""this would be perfect for spin class, a quick sprint, or a yoga cool down."""	WELLNESS
If you'd rather be doing nothing other than being with your partner or spouse, but having a hard time concentrating on what they're saying to you, take a moment to center yourself so that your focus is on them. That can help pull you in the moment instead of allowing your mind to wander	WELLNESS
The more you learn to love and value your unique essence, the less you will find yourself comparing yourself to others. There is only one you. You are incomparable!	WELLNESS
So here's what I learned from Tiffany about helping a friend who's hurting. Don't be afraid of breaking her. Ask what would help. And go ahead and ask for something right back. Nothing heals like knowing you're needed.	WELLNESS
Nowadays, as times have changed, everyone is constantly on the go; with sports, camps, meetings, commitments, commitments	WELLNESS
The president spoke with Russian President Vladimir Putin on Sunday.	POLITICS
Flagler College attracts a wide variety of students. In turn, campus style ranges from the admirable to the laughable. It's not uncommon to spot a few girls in only their bikinis, a handful of lost fanny-pack sporting tourists and a dude dressed as a pirate in any given classroom.	STYLE & BEAUTY
Looking fabulous. üíÖ	ENTERTAINMENT
What if your definition of shopping was less trolling the mall and web and more sitting front row at a fashion show, taking	STYLE & BEAUTY
Bombshell after bombshell.	ENTERTAINMENT
It's going to be flawed and confusing. That's what happens when an organization makes nutrition recommendations for 300 million different humans, all with different bodies and dietary needs.	WELLNESS
Broadway isn't exactly a shining example of diversity, but you aren't going to see #TonysSoWhite anytime soon.	ENTERTAINMENT
The festival was Weinstein‚Äôs ‚Äúhunting ground,‚Äù she said.	ENTERTAINMENT
Tourism is booming¬†in Thailand, and it seems like everyone knows about the main beaches and islands¬†by now. The country is	TRAVEL
The push for a ban on the devices has stalled in Congress.	POLITICS
"Name: Erikka Steele Age: 21 Height: 5'9"" Before Weight: 212 pounds Breaking Point: In March 2012, I made it a point in my"	WELLNESS
When not present, we are in ego.  Our perceptions and experiences are distorted by judgments that have more to do with our past then our present.	WELLNESS
We're all so concerned with getting ahead and keeping up with the Joneses these days that sometimes we forget that one day the Joneses won't matter anymore. And that's the day you need to prepare for.	WELLNESS
The Duchess of Sussex's first public investment is a very trendy one.	ENTERTAINMENT
Facing a tougher than expected challenge from Senator Bernie Sanders of Vermont, Hillary Clinton‚Äôs campaign is preparing	POLITICS
Bill Cosby‚Äôs daughter, Ensa Cosby, died from a chronic kidney disease.	ENTERTAINMENT
In Bermuda, houses are painted sherbert yellow, green and blue and the pinkish sand on every beach is as soft as flour.	TRAVEL
You've got 'em cornered and they can't even throw a drink in your face.	TRAVEL
The researchers found an association between areas that had been affected by the emerald ash borer beetle -- which kills	WELLNESS
"""Bridesmaids"" first hit theaters on May 13 of last year and her upcoming comedy, ""Identity Theft,"" has just been slapped"	ENTERTAINMENT
Even if you are lucky enough to have ditched the diaper bag, chances are there are still sippy cups, snacks, extra clothes and strollers to contend with. But not all kiddie-related travel is doom and gloom.	TRAVEL
Brittney was very lucky that her wits prevailed and she never got on that plane. Don't get distracted by everything going	TRAVEL
"Oxford is sui generis, literally ""of its own kind."" Poet Matthew Arnold described it as ""that sweet city with her dreaming spires."" It is home to the oldest university in the English-speaking world. To pop culture fans, Oxford is something more."	TRAVEL
Perhaps the most dichotomous artistic event of the year, Fashion Month throws together polar opposites that truly shouldn't work but just do	STYLE & BEAUTY
"""It's a tremendous loss,"" said one education official of the death of a 30-year teacher."	POLITICS
PHOTO: The shot features Keira styled in a look that we can only describe as a futuristic '90s hybrid (not too far a cry	STYLE & BEAUTY
ALL the feels.	ENTERTAINMENT
Conscious loving requires us to come out from behind the security of our manufactured image and expose ourselves to the threat of emotional pain that we desperately wish to avoid.	WELLNESS
Film legend Ernest Borgnine sadly passed away from renal failure on Sunday. He was 95. Perhaps best known for his Oscar-winning	ENTERTAINMENT
"""If they succeed, you can kiss our democracy goodbye,"" cautioned Clinton-era Cabinet member Robert Reich."	POLITICS
"As an avid traveler, I pride myself on my sense of being in the moment with each new journey and destination. Yet the second my camera, the proof of ""how much fun I was having"" was lost, I became inconsolable. It forced the unpleasant question of the motivation behind my travel."	TRAVEL
A massive tax cut doesn't have to be regressive.	POLITICS
Hint: she would probably make a bad teacher.	STYLE & BEAUTY
Beautiful white sand beaches mirrored by whitewashed houses lined along the mountainside, the breathtaking Greek Islands are everything you expect and more. And with prices dramatically down this year, why not experience the mystical beauty which has captured the hearts of all who visit since the time of the Gods?	TRAVEL
This is what the dismantling of the Voting Rights Act looks like.	POLITICS
You see, in the fashion world there is always someone telling you to suck something in, suck something up or surgically suck something out. But today, all of this is about to change.  And I've decided to start with the Holy Grail of body betterment -- the abs.	STYLE & BEAUTY
During his raucous campaign rallies, Trump often incited protests and violence against reporters.	POLITICS
Consumers are responsible for making healthy food choices, not industry, food service establishments exclaim. But how can consumers make better choices if industry continues to fight to hide the caloric content of their food?	WELLNESS
Tatiana Maslany's leading man (and Kit Harington's drama school mate) finds his own nook in Hollywood.	ENTERTAINMENT
"""It makes me wonder, are they taking the Latino vote for granted?"""	POLITICS
Are you expecting your job to be stressful? No free time? Your partner to disappoint you? Your health to decline? Murphy's Law to win? Well when you look at it that way, your wishes are the universe's command.	WELLNESS
Parents are scared, state officials are scrambling and Congress is about to go on vacation.	POLITICS
In America, we have something called the Medal of Honor.  It is a military award that is only given to the people that went above and beyond reasonable expectations of bravery to achieve something truly heroic.  Here is a list of 10 of our greatest American heroes.  On this 4th of July, take one of these stories and tell it to your buddies over the grill, or while waiting for the fireworks.	POLITICS
Yes, there's another one.	POLITICS
The best of summer's pop culture celebrates youthful ingenuity.	ENTERTAINMENT
"Emma Watson (""Harry Potter,"" ""The Bling Ring"") is set to star in an adaptation of Emma Forrest‚Äôs memoir, ""Your Voice in My"	ENTERTAINMENT
It wasn't me, really.	POLITICS
Vote for a ticket that Republicans will love and the nation can accept.	POLITICS
As COVID-19 cases surge, many Americans are ignoring health guidelines with beach days and vacations. Pretending the coronavirus crisis doesn't exist will just stretch it out longer.	WELLNESS
The first openly bisexual member of Congress could end up facing off against a Republican whose own party has called her a conspiracy theorist.	POLITICS
WASHINGTON, Sept 24 (Reuters) - U.S. President Barack Obama would veto legislation to continue funding the government if	POLITICS
PHOTOS: The Duke and Duchess of Cambridge triumphed in a lawsuit on Tuesday that allowed them to halt Closer magazine's publication	STYLE & BEAUTY
"Rep. Clay Higgins called for ""invincible"" military while in death chamber."	POLITICS
As the countdown to a new year begins, excitement in the air grows! To many of us, a new year signals a time for new beginnings, a time for a fresh start.	WELLNESS
What else can we photoshop onto the frozen smiles of the Kardashians? Hula skirts? Fuzzy koala costumes? Soul patches? Perhaps	STYLE & BEAUTY
Although Prince Harry has made more headlines recently for what he hasn't worn (yes, we are talking about those nude pictures	STYLE & BEAUTY
"‚ÄúI‚Äôm going to die here by myself. Where do people expect all the refugees to go?"""	POLITICS
In 2014, NIH research funding for cancer was $56 million less than it was in 2010. This means we now have to fight for increased funding at a time when potentially monumental breakthroughs are in our grasp. In the war against cancer we've had to open up a second front.	POLITICS
Activists insist the party can drag out the process.	POLITICS
Or at least make it a tiny bit better.	ENTERTAINMENT
Here at Brik Fitness, one of our core values is to inspire... through fun!  One of the most effective tools? Great music! A great playlist truly allows our clients to unfold, get into a rhythm and just flow with exercise!	WELLNESS
"The ""Les Mis√©rables"" inspired musical number is wonderful."	ENTERTAINMENT
Unlike the police, firefighters do not have a public perception problem. They aren't perceived as an occupying army and they don't need a Department of Justice database to keep track of how many people they kill annually.	POLITICS
It's been freezing in Washington for the past few months, but it wasn't the nuclear winter some predicted when Sen. Harry Reid ushered in the most important changes to Senate procedure in a generation.	POLITICS
You better, work! Even though that sounds a little snooty, Evangelista stood out among her model contemporaries in the '90s	STYLE & BEAUTY
And it's made of WHAT?	STYLE & BEAUTY
A 5-year-old from the U.K. is able to enjoy food and drink after undergoing treatments to help him get over his fear of eating	WELLNESS
Presidential hopeful Marco Rubio has made a huge push to gain millennial supporters this past week, most notably his ad released Tuesday. The ad features a group of millennials, who are all concerned about differing issues facing the country and believe that Sen. Rubio is the answer.	POLITICS
Actor Joe Keery talks about a clue in the new episodes.	ENTERTAINMENT
Republican presidential candidate tells the Guardian that country should be ‚Äòvigilant‚Äô in cases of abuse, but ‚Äòoverwhelming	POLITICS
"Mary Trump rips her ""severely damaged"" uncle."	POLITICS
"Trump on Sunday called mail-in voting a ""Scam!"" ‚Äî even though he personally took advantage of such voting himself."	POLITICS
"The researchers noted that to an extent, the more cherries that were consumed, the lower the risk of gout attack. ""The gout"	WELLNESS
"The Faux Pas: ""When a client attempts the overhead press, they generally wind up with a tremendous arch in the lower back"	WELLNESS
See more of Kate Upton's work below! 5. Wtfffffff. The Mirror reports that the ad was banned by some networks. (Although	STYLE & BEAUTY
An El Salvadoran national is accused of beating 17-year-old Nabra Hassanen with a baseball bat.	POLITICS
The twisted tale of a dubious document leaves more questions than answers.	POLITICS
I've never been big on New Year's resolutions. Rather, I regard these as commitments of evolving, on a journey to always strive to be better.	WELLNESS
Don't give up. Don't allow breaks in your routine to become permanent. Don't be frustrated if progress in running faster or lifting heavier weights is slower than when you were 20 years younger.	WELLNESS
Yoga Teachers will sink or swim together.  The sooner we figure out a sustainable win-win business model regarding how to freely share the benefits of this rich tradition, the sooner we will all prosper.  Ommmmmmmmmmm.	WELLNESS
"Demonstrators chanted ""refugees are welcome here"" and ""love trumps hate."""	POLITICS
"""If you wanted to take credit for it, you probably should've voted for it,"" one critic tweeted."	POLITICS
O' Canada -- this is the best mall ever!	TRAVEL
How far would airlines go to collect a few more bucks from you? If nothing would surprise you anymore, then you should hear Hesha Duggirala's story.	TRAVEL
Gregg Pemberton was quizzed about his use of Twitter by defense lawyers.	POLITICS
There are ways to push through the invisible wall and squeeze every last drop out of a workout. Read on for tricks and tips	WELLNESS
A nine-state coalition could aggressively cut carbon emissions, but they're split on whether to do so.	POLITICS
‚ÄúYou cannot take that position while in uniform,‚Äù said a San Antonio city councilman.	POLITICS
By Day 3 it's become clear that the Toronto film fest 2014 is above all about the year of the actor, male and female.  As I toggle between one theater and the next, I discover yet another film that raises the bar on the art of screen performance.	ENTERTAINMENT
The Supreme Court must side with the American people, not partisan operatives.	POLITICS
Champion skier Lindsey Vonn is in the hospital following a Tuesday night crash during the opening day of the women's Super	WELLNESS
I think it's important to remind yourself that the things you do each day are not burdens, they are opportunities. So often, the things we view as work are actually the reward. Embrace your constraints. Fall in love with boredom. Do the work.	WELLNESS
"Robert Frost once noted, ""A jury consists of twelve persons chosen to decide who has the better lawyer."" The jury in the trial of George Zimmerman consists of six woman, and this playlist goes out to these sequestered Americans as they try to make sense of this case."	ENTERTAINMENT
No American can possibly believe that he or she now is living in that exceptional land of patriotic possibility.	POLITICS
"On ""The Bachelor"" as in life, perhaps running a multimillion-dollar company does not automatically equal emotional intelligence ‚Äî and other lessons from Episode 4."	ENTERTAINMENT
Bob McDonald said something dumb. Now he's paying for it.	POLITICS
Next time you really need to get away from it all, the Fogo Island Inn is calling your name. The inn has a futuristic, minimalistic	TRAVEL
The flag, the Bible, the cross, the ring, the badge, the collar... we are a country rife with symbols, literally wrapped	POLITICS
Like what you read below? Sign up for HUFFPOST HILL and get a cheeky dose of political news every evening A poll finds the	POLITICS
States have taken widely varying approaches.	POLITICS
Maybe the Arizona senator thinks he can avoid answering questions about his party's standard-bearer forever.	POLITICS
Donald Trump poses a threat to global security, the publication says.	POLITICS
"The Republican leading the charge says that when Congress comes back after November elections, ""the American public gets screwed."""	POLITICS
The artery brought fresh blood to the woman's reattached ear, but the surgical team couldn't find a vein to drain blood back	WELLNESS
Researchers said these findings could have implications for both the legal system and policy-related judgments. ‚ÄúIntentional	WELLNESS
Republicans will spend the next two days grilling Jackson on her record. They've already signaled plans to attack her for being ‚Äúsoft on crime.‚Äù	POLITICS
A judge dismissed just one of the felony charges against six defendants on Wednesday, leaving them exposed to potential lengthy prison sentences.	POLITICS
"""Insofar as extraverted children appear to be more at risk for influence by environmental cues, there are two different serving"	WELLNESS
Have you recently been through a challenge, disappointment, break up or disloyalty with somebody in your life? If so, it's important to take some time to think like a lion tamer about your pain, so you can tame the possibility of more negativity coming back to bite you again!	WELLNESS
The McFlyest selections.	ENTERTAINMENT
Virtually no one dies of old age, per se, but they died unnecessarily of preventable illnesses.	WELLNESS
New Minority Leader Chuck Schumer also added some conservative members to leadership.	POLITICS
Do you hop out of bed first thing in the morning and hit the gym? Maybe you prefer a late-night workout before bed. Either way, the food you consume pre- and post-workout are just as important as the workout itself.	WELLNESS
The moment you accept responsibility for your reactions to anything that is happening around you, you have no way back. The moment you recognize that you are the one choosing your reactions, the blame and complain game ceases to have power over you.	WELLNESS
And only 29 percent of GOP voters have favorable views of Donald Trump's chief strategist.	POLITICS
Yes, that Boy Scouts thing wasn't that long ago.	POLITICS
"One of the benefits of hitting the shore in autumn is affordable hotel rates, putting dream destinations like Hilton Head, Montauk, Laguna Beach, and even Nantucket within your reach. Here are our favorite American beach towns with fall rates that say, ""Welcome!"""	TRAVEL
Back to school can be a time of adjustment.  Just as students might need time to adjust to new teachers and subjects, the school lunch program might need time before it is fully accepted by students or financially successful.	WELLNESS
See Shailene's endearing red carpet moment below and tell us if you'd grace the red carpet without shoes. The actress attended	STYLE & BEAUTY
And it's kind of an important one.	STYLE & BEAUTY
"From Ramshackle Glam From time to time on RG, I've used the expression ""it's not all sparkles and rainbows"" (or some variation"	STYLE & BEAUTY
In continuing my dissection of the obfuscations and half-truths of Clatsop County DA Josh Marquis, I happened upon a statement of his on his personal Facebook page that claims Measure 91's legalization of marijuana won't provide any tax revenues to local law enforcement.	POLITICS
"The jazz musician also wrote classic kids songs like ""Three Is a Magic Number"" and ""Conjunction Junction."""	ENTERTAINMENT
The pop star opened up about her ongoing eating disorder recovery.	ENTERTAINMENT
Shots fired (back).	STYLE & BEAUTY
üé§ And now I'm singing like... üé§	ENTERTAINMENT
When you were a kid, the refrigerator was your canvas. You'd match colors, create words and eventually form sentences. It	WELLNESS
The demonstration coincides with the major climate summit in Paris.	POLITICS
And Norma Kamali was the one who got us inspired. Chatting with the designer on HuffPost Live, we learned that she swears	STYLE & BEAUTY
The Senate Intelligence Committee is investigating the Trump campaign's ties to Russia.	POLITICS
"Doug Greenberg, one of Garde Robe's partners, tells the Times that his clients ""are wise enough to protect [their clothing"	STYLE & BEAUTY
Republican legislators are intentionally deceiving Americans about who foots the bill as they cut taxes for the rich.	POLITICS
Less care for higher cost, all the while providing billions in tax breaks to the super wealthy.	POLITICS
In addition to using common ingredients like fruits and vegetables or almond butter and flaxseed, Superfood Smoothies also focuses on exotic superfoods, many of which will be new to readers.	WELLNESS
Young kids haven't quite learned to eye-roll. In most cases, mommy and daddy are still heroes, so you might as well capitalize on that while you can. Go on: Impart your worldly wisdom, share your interests and infect your kids with the travel bug before it's too late!	TRAVEL
Entrepreneurs who are just starting out should pay close attention to the way Trump is running his Presidential campaign. You don't have to agree with his politics or his blunt delivery. Whether you love him or hate him, Trump's campaign showcases five traits of entrepreneurship at its best.	ENTERTAINMENT
"""The facts speak for themselves,"" said Log Cabin Republicans' Gregory T. Angelo."	POLITICS
As is tradition at each of our tour guide summits, last weekend I invited our guides into my home for a party. As is also	TRAVEL
It was around 10:30 p.m. when Steve Jacobs rolled down the gravel driveway. The air was warm for early January, even for	POLITICS
By: Brian Berger, Space News Published: 05/31/2012 05:31 AM EDT on SPACE.com George Whitesides, Virgin Galactic's president	TRAVEL
To the good life.	ENTERTAINMENT
When Omar Mateen opened fire with his military style AR-15 assault rifle on a gay nightclub in Orlando, there was one man	POLITICS
"""I don't get it."""	ENTERTAINMENT
Make the most out of a short period of time.	TRAVEL
"f I had a wish and a dream, it would be to get Congress in my salon.  It would be difficult to argue with each other while John Boehner is getting a ""conservative, side part to the right,"" and Nancy Pelosi is receiving cover for mother nature ""highlights."""	STYLE & BEAUTY
Early in this election campaign, we began appending an editor‚Äôs note to our coverage of¬†Donald¬†Trump, highlighting his racism	POLITICS
Reddit was certainly not amused.	STYLE & BEAUTY
"Your dad may feel that you are ""in on the joke,"" and indeed this may have been par for the course in the past. However, it's now your job to make it abundantly clear times have changed and you will no longer tolerate being publicly humiliated. You have a responsibility to advocate for yourself."	WELLNESS
The choice between New Yorkers paying their fair share for a world-class transit system and selling sponsorships to multinational corporations is clear.	POLITICS
This is the first time since July that Trump has fallen out of first place.	POLITICS
What happened?	STYLE & BEAUTY
Kathleen Hartnett-White's views on fossil fuels and pollution proved too extreme for even some Republicans.	POLITICS
In this Postcard from Spain, our guide Bo Lohmann shares with us his favorite Spanish recipes, wines and sights (plus tells us the real reason why he always travels with a Swiss Army knife).	TRAVEL
Ted Cruz spoke for over 80 percent of his time questioning Jeff Sessions during today‚Äôs confirmation hearing, probably because	POLITICS
No policy changes were announced after a four-hour discussion with the players union.	POLITICS
This week's definitive listing of the worst from the White House.	POLITICS
"Things got crazy in ""Twice As Far."""	ENTERTAINMENT
Do you sometimes find that you sabotage yourself in your work or your relationships? Have you wondered why you would do that? Here are some of the beliefs that might trigger your fears or your resistance to taking loving action in your own behalf.	WELLNESS
"Interrogating residents about their votes ""can have a significant intimidating effect on qualified voters,"" warned a Justice Department official."	POLITICS
"Have you seen the late George Carlin's riff on ""stuff""? If you haven't, it is brilliant and hilarious, and it exemplifies so much of what I believe about the over-filled, over-scheduled, over-thought, and over-wrought experiences that we now call life in 21st-century America."	WELLNESS
"Endless inspiration from the one and only ""This Is How We Do"" singer."	ENTERTAINMENT
"The ""Infowars"" conspiracy theorist said it was ""a legitimate question to ask."""	POLITICS
We now know much more about hormones and the male body. But for most men, hormones are still a mystery.	WELLNESS
"""God is using Pope Francis to prod our consciousness."""	POLITICS
Newly released documents related to its Rover pipeline give weight to critics who call Energy Transfer Partners a ‚Äúwolf in sheep‚Äôs clothing.‚Äù	POLITICS
The Identical is a movie that should be seen for the discovery of Blake Rayne if for nothing else. But it also has an interesting storyline, and solid performances by Liotta and Judd. Throw in some hummable tunes and you have a movie satisfactory for the entire family.	ENTERTAINMENT
We're not really sure what she has starred in recently or why she was at the Golden Globes, but damn did she look good. The	STYLE & BEAUTY
Their stories are, unfortunately, all too common. The fact they happened around Christmas is a reminder that heart disease can strike anyone at any time. So as you cherish the time you spend with your loved ones, please also be wary and take any symptoms seriously.	WELLNESS
Capturing that magical moment of a marriage proposal can't be an easy task for any nervous dude, but getting the perfect	TRAVEL
"‚ÄúThis show is not about reliving people‚Äôs sexual assaults."""	ENTERTAINMENT
The actor referenced Edward R. Murrow‚Äôs famous words during a speech on Friday night.	ENTERTAINMENT
ALBUQUERQUE ‚Äî As he does at nearly all his rallies, Donald Trump made a dramatic promise to thousands of his followers at	POLITICS
Don't use the cancer card to have your school workload reduced, to cheat on tests, or get paid to do nothing. Use it instead to get the big piece of chicken at dinner.	WELLNESS
"‚ÄúTo me, it was just like, ‚ÄòOf course that character exists!‚Äô"""	ENTERTAINMENT
It turns out that making one particular drug harder to abuse does not suddenly cause a drug-free life for people addicted to OxyContin. If only it were that simple, but it's not.	WELLNESS
You can see Deepak's whole conversation with Michelle at NEWSWIRE.FM As caregivers in most societies, women are taught to	WELLNESS
But it's not just a reproductive rights dispute standing in the way of passage.	POLITICS
"The ""Will & Grace"" actor hilariously recalled his time behind bars when the future ""Iron Man"" star also was serving time."	ENTERTAINMENT
"The ""Roar"" singer said a lot to a contestant with very little."	ENTERTAINMENT
The National Restaurant Association is perhaps the largest trade group that you have never heard of.	POLITICS
ISIS has no monopoly on cruelty or immolation. On the contrary, it has exploited for its own ends the shock value of something used for centuries to punish and terrify heretics and African-Americans, and lately used by desperate dissidents around the world upon themselves.	POLITICS
Styling your life is all about taking accountability for what exists in your orbit and implementing practices that reinforce the intention of loving yourself and living out your goals.	WELLNESS
The Republican strategy will let people die, the outgoing senator said.	POLITICS
Like what you read below? Sign up for HUFFPOST HILL and get a cheeky dose of political news every evening!¬† Joe Biden reminded	POLITICS
"After realizing he confused the  slain boy's case with another, the presidential hopeful said that ""the process worked."""	POLITICS
"""It's a substantial reduction for the middle-income people."""	ENTERTAINMENT
Like most things these days, it has to do with Cardi B.	ENTERTAINMENT
But this is not what Republican plans would do.	POLITICS
"""How can you not be pansexual in space?"" he said."	ENTERTAINMENT
Memorial Day offers an annual remembrance of courage and sacrifice as well as the all-too-frequent foolish and counterproductive effusion of American blood.  Most of the conflicts in which so many Americans died were fool's errands, wars which the U.S. should never have fought.	POLITICS
The Satanic Temple claims it violates its beliefs.	POLITICS
It has been five years since the statutory deadline for final rules on gluten-free labeling, and the FDA has taken no final action. Five years. It is time for the FDA to do something.	WELLNESS
If you think of a job loss as an opportunity instead of as a reason to panic, it can be the wake-up call that prompts you to finally commit to having the career you really want.	WELLNESS
‚ÄúEvery woman of my vintage knows what sexual harassment is, although we didn‚Äôt have a name for it,‚Äù Ginsburg said.	POLITICS
I had the honor of interviewing U.S. Astonaut Clayton C. Anderson about his oral hygiene habits while living on the international space station for six months.	WELLNESS
Dozens of Democrats and Republicans in Congress are fighting cuts to a program that rural communities rely on for clean water.	POLITICS
The executive order provides $250 million for necessary repairs, upgrades and construction in public housing.	POLITICS
Karena Virginia said the experience made her feel ashamed for years.	POLITICS
A survey found record-high support in California for life imprisonment rather than the death penalty for first-degree murder.	POLITICS
#NEVERMICHELLE	POLITICS
Launched by a '70s sitcom, this lady had it goin' on.	STYLE & BEAUTY
Only one of these drugs belongs among the most dangerous substances.	POLITICS
Trump is a big factor in many states.	POLITICS
Catch a peek of the Victoria's Secret Fashion Show tonight as we live-tweet and Instagram from the front row, and see the	STYLE & BEAUTY
These two are proof that true love exists.	ENTERTAINMENT
Everyone, at some point, wonders how they would react to a split-second emergency. Fight or flight? Leap into action or race for the exit? Or simply crumble?	ENTERTAINMENT
Contributions are flowing to Democratic Party committees and candidates at record levels.	POLITICS
The racist attack on the federal grand jury in D.C. adds to the ways the president's backers are trying to discredit the Russia probe.	POLITICS
Rome is not Milan. Moving from one part of the city to another can take hours (no exaggeration, just try). So here are some	TRAVEL
A new pro-Israel ad has sparked controversy, not for its subject matter but for its star: Bar Refaeli. Then in 2010, Maj	STYLE & BEAUTY
The GOP's dogged vow to hamstring Obama with the tag of a go-it-his-way president and further straightjacket his presidency poses the real likelihood that Lynch could be on the GOP's hot seat. If so, the issue again will not be Lynch, but Obama.	POLITICS
When your mind starts racing and your body begins tensing up, stopping to count your breath is one of the easiest ways to	WELLNESS
There is an uplifted quality that naturally exists in our lives. It is an innate awareness of our unique and sacred existence, which is automatically stirred in our mindfulness of the present moment.	WELLNESS
White House legislative affairs director Marc Short then defended it, saying the message is on point.	POLITICS
"Asked about the risk factors for contracting the disease, Memish said: ""It seems like being a male is a risk factor, being"	WELLNESS
Let's break out the sequins and the feather boas and have dessert first!	WELLNESS
Co-Director Pierre Coffin invents his own gibberish... Phoenix keyboardist Rob composes for a Maniac...	ENTERTAINMENT
It started small. My vision was a little blurry after working on the computer for a few hours. Then, I started to get headaches in the late afternoon. A few weeks later I noticed that I was having trouble reading street signs. Sound familiar?	WELLNESS
"Feeling angry can be beneficial to a person with cancer. It provides a means to vent and let off steam. After all, if anyone deserves to feel angry, it's someone with cancer. I believe it's even essential to feel anger in order to ""process cancer"" -- just not all the time."	WELLNESS
That's before some women even realize they're pregnant.	POLITICS
Fatigue is lethal to inspiration. Avoid anyone who drains. Go towards energy hot spots in your job -- people and activities -- so your time is skewed towards inspiration.	WELLNESS
Researchers found that exposure to different chemicals and solvents was linked to an increased risk for Parkinson's disease	WELLNESS
üé∂  I know a girl who's tough but sweet. üé∂	ENTERTAINMENT
"On Thanksgiving, after we finished dinner, we moved to the family room. Each person chose a gratitude bag, took a pen and as many strips of paper as there were people present. The assignment was that we would write a ""compliment"" or a ""thankful"" note to each person."	WELLNESS
April is shoulder season for many North American destinations, so this can also be a wonderfully affordable time for a carpe diem-inspired break. Here are five great family destinations that beckon in April.	TRAVEL
"""It‚Äôs just the craziest thing I‚Äôve seen all week, because I saw that movie with the lady having sex with the fish and still this beats that."""	ENTERTAINMENT
Research has suggested that's because infants don't have the neural capabilities needed to retain an autobiographical memory	WELLNESS
In honor of the holidays, Greatist has picked 20 fitness-inspired gifts we'd love to unwrap this festive season. Some of	WELLNESS
"""Rogue One"" star Felicity Jones says it's ""a film that‚Äôs about unity."""	ENTERTAINMENT
Kim Davis says it's against her religious beliefs.	POLITICS
Recently I was asked if I thought the tragedy of Trayvon Martin's killing would cause more people to take an interest in	ENTERTAINMENT
An insider's guide to what could be the struggle to win a contested convention.	POLITICS
"With a sunny disposition and a tummy full of honey, he believes ""nobody can be uncheered with a balloon."" Want more simple"	WELLNESS
It sounds like she'd love to be a part of it.	ENTERTAINMENT
There have been six in Oscar history. Here's what they were, and how PricewaterhouseCoopers plans for the drama.	ENTERTAINMENT
The storm set off landslides, flooded low-lying villages, destroyed houses, downed trees and electrical poles and knocked out power in entire provinces.	POLITICS
I am a big believer in the power of group fitness. Whether it's the energy of hundreds of yogis sweating together at an outdoor festival or a group of 40 spinners rocking out to Kanye remixes, group fitness inspires healthy camaraderie and shines a bright light on the world of wellness.	WELLNESS
Technology unites us, but at the same time, isolates and distracts us. The level of discourse in our national debate is at a low point. We feast on trashy, tabloid reality shows. And we are awash in violent images.	ENTERTAINMENT
"Do you need pain relievers every day because you're sore from sitting and typing, texting or slouching? I've dubbed this new pain syndrome ""technomyalgia,"" because it causes pain and muscle soreness."	WELLNESS
"She also noted: ""Much has changed in a year. And much has not. Love my cousin and sister. A year of intense growth shared"	STYLE & BEAUTY
It's our job, not God's, to create the new story of who we are, and millions -- billions -- of people fervently wish we could do so. The problem is that the worst of our nature is better organized than the best of it.	POLITICS
You're making the rest of us look bad, Bernie.	POLITICS
Is this finally the week that Netflix debuts a good sci-fi thriller?	ENTERTAINMENT
The potential move to revoke his membership comes as the British Academy of Film and Television Arts cut ties with the producer over sexual abuse reports.	ENTERTAINMENT
"The film ""Us"" will hit theaters next March."	ENTERTAINMENT
"Sen. Susan Collins said government officials should be treated the ""same way we would treat a soldier who suffered a traumatic injury on the battlefield.‚Äù"	POLITICS
This is off to a great start.	POLITICS
Choupette Lagerfeld may be the most famous (and spoiled) cat in fashion. Not only is she the subject of a recent profile	STYLE & BEAUTY
It's not easy to deal with setbacks -- they are emotionally arousing, draining, and taxing. The good news, though, is there are specific skills that can help you turn a setback into a comeback.	WELLNESS
"""Don‚Äôt let the fascist victim complex hit you on the way out,"" Rep. Alexandria Ocasio-Cortez responded to the former Donald Trump adviser."	POLITICS
There's no consensus option left.	POLITICS
Gillette also had a special message for Lochte: Lochte was gifted with two razors -- one gold-plated and the other diamond	STYLE & BEAUTY
For a guy who got famous for hiring and firing people, he doesn't seem to be great at doing background checks.	POLITICS
Trade deals are one subject (one of the very few left) which do not break down on party line. Both the Republicans and the Democrats are split over the issue, so it's not a repeat of the usual partisan battle lines. But it is a clear defeat for Obama, who lobbied hard to very little effect.	POLITICS
From Josh Duggar to Ariana Grande, these celebs saw more than their fair share of scandals in 2015.	ENTERTAINMENT
Read the rest of her interview on Vogue.com to learn about her relationship with fame and the inspiration behind her interesting	STYLE & BEAUTY
His future customers? You'd be hard-pressed to find a kid as stylish or as motivated as Moziah Bridges. At just 11 years	STYLE & BEAUTY
My name is Jordan Reeves. I‚Äôm gay. I‚Äôm from Hueytown, Alabama. And, I‚Äôm concerned. I‚Äôve written about how as a gay man that	POLITICS
‚ÄúDomestic terrorism ‚Äî driven by hate, bigotry, and other forms of extremism ‚Äî is a stain on the soul of America,‚Äù President Joe Biden said.	POLITICS
"I'm ready to make a few New Year's resolutions: I vow to try out Waldman's notion of ""shouldlessness,"" that is, to live without tight hold of a map about how life should proceed. I vow to try to embrace life exactly the way it is, in all of its imperfections. I also vow to try to learn to live with the discomfort of disappointment."	WELLNESS
Here's a list of 5 ski resort towns that require sticks as well as poles.	TRAVEL
‚ÄúEmpathy is really important for understanding others' emotions very deeply, but there is a downside of empathy when it comes	WELLNESS
Don't toss out your salt shaker just yet: A new analysis from Denmark finds current recommended salt guidelines may be too	WELLNESS
A Supreme Court ruling has left the state's judicial system with a lot of question marks.	POLITICS
Feeling spontaneous? Want to avoid the in-laws? Just need to get away? Poshbrood has rounded up 5 last-minute Thanksgiving getaways.	TRAVEL
I started wearing a training bra when I was three years old, not because I needed one or because I was self-conscious, but because I thought that bras were beautiful. I remember going to the department store with my mother and helping her pick out her bras, black ones, lacy ones, silky ones; they fascinated me.	STYLE & BEAUTY
Cue the swooning.	STYLE & BEAUTY
The Iraq invasion didn't go as she had expected.	POLITICS
Need for Speed is a movie based on a videogame of the same name. As such it has a built in audience with it from the start. All others will sign on at their own risk -- of boredom	ENTERTAINMENT
On Holocaust Remembrance Day, it's worth actually remembering the Holocaust.	POLITICS
He threatened to kill DACA and wants to send the military to the border.	POLITICS
"This year's theme is ""Tourism and Water: Protecting our Common Future"" held in Maldives, an island nation in the Indian Ocean"	TRAVEL
The pro-Russia change was the only party platform tweak the Trump camp cared about, sources say.	POLITICS
To find unity, we have to go beyond those differences; we have to surrender our own needs for the benefit of all. In the process, our enemies can teach us great patience and even compassion!	WELLNESS
Seriously, you would not want to get stuck sitting here on a long flight -- or, really, any flight.	TRAVEL
7. They calm dry scalp and remedy dandruff. We're huge believers in DIY hair masks. Massaging a combination of household	STYLE & BEAUTY
Maybe he wants to be nice. Or maybe he wants to avoid a convention fight.	POLITICS
I am a little bit insulted by the emails I‚Äôve gotten this week from various progressive groups, saluting me as ‚Äúa healthcare	POLITICS
We're pretty excited about all the beef stew and Bailey's we plan on imbibing this weekend.	TRAVEL
The Trump International Hotel has tried and failed to quash a union drive.	POLITICS
"""We urge you to
affirm America‚Äôs values and tradition as a nation of immigrants,"" reads a letter to the president."	POLITICS
These hikes  may be the loveliest in the world. Go for a walk.	TRAVEL
It's all part of the president's strategy to distract his base.	POLITICS
On election day in 2016, Donald Trump surprised most of us by defeating Hillary Clinton (although he garnered only 46.1 percent	POLITICS
"""He just wanted to go home,"" a passenger who took the new video said."	TRAVEL
A month after Hurricane Maria hit, 80 percent of the U.S. island has no power and 30 percent has no drinking water.	POLITICS
A new breed of sports drinks, backed by a decade of studies, are challenging common assumptions about how best to hydrate	WELLNESS
So, you think you're a real fashionista, hm? You pay attention to all the happenings in the style world, do you? Well, then	STYLE & BEAUTY
He still trails Clinton nationally but is in a statistical tie in New Hampshire.	POLITICS
Or ignoring them altogether.	POLITICS
The contempt ruling sent her to jail.	POLITICS
The ban affects travelers with passports from Iran, Iraq, Libya, Somalia, Sudan, Syria and Yemen.	POLITICS
Everyone is stressed -- but the difference in how that stress affects our health hinges on how we handle it, said Dr. Dean	WELLNESS
Go back to what it what like growing up -- both in and outside the home. Think about school, social life, etc. Even in your young adult life and into adulthood, what were experiences that happened to invoke these emotions? Why?	WELLNESS
Don't look now, but the midterm elections are not the only huge November win for the politically conservative Koch brothers, and likely not even their most relevant. The CSX Transportation company, a subsidiary of Koch Industries, also scored a huge civil court victory.	POLITICS
Seatbelts and oxygen masks have never seemed so funny.	TRAVEL
Teachers say they left the meeting disappointed and frustrated.	POLITICS
Last week, the International Air Transport Association ruined every maximalist packer's day by recommending new, smaller carry-on sizes -- the idea being to maximize overhead space, so that every passenger has room to store a bag.	TRAVEL
"The wit is 24/7 on his ""4:44."""	ENTERTAINMENT
On a return trip to Cape Cod, some of the top things to see and do in Chatham, Massachusetts.	TRAVEL
Common, she looks cute.	STYLE & BEAUTY
Our bodies are intelligent. While we spend much of our time trying to get our bodies to conform to our desires, we actually need to spend more time having our desires conform to the wisdom of our bodies.	WELLNESS
"""We‚Äôre treated as second-class citizens."""	POLITICS
Myron Ebell wants Trump to pull the U.S. out of the Paris climate pact -- and he thinks the secretary of state is standing in the way.	POLITICS
Or this: 4. When people are going to the checkout with an arm full of clothing, it's easy to get caught up in the mentality	STYLE & BEAUTY
"""It's hard for a person who is homeless to have dignity."""	POLITICS
"He said in some cases Trump was ""even ahead of me"" in his thinking."	POLITICS
Who got the final rose?	ENTERTAINMENT
I'm in no way suggesting that hurt and depression are good places to hang out. They're not. I'm all about happiness, joy and fulfillment! However, when things in your life aren't working or you're feeling down and overwhelmed, sometimes you have to fall apart.	WELLNESS
Many of the millions of people who actually do yoga in this country do it so they will look hot and have a rocking body, while many of the people who teach and cultivate yoga in this country turn a blind eye to this and pretend that everyone does yoga purely for the deep spiritual insight.	WELLNESS
It's difficult to imagine anyone else winning the nomination now. But screw it, let's try!	POLITICS
On anything.	POLITICS
